111111
1000P1
100001
100001
100CE1
111111
