1111111111111
100P000000001
100000000C001
1000E00100C01
1000000000001
1111111111111
