1111111111111
1000P00000001
100000000C001
1000E00000001
1000000000001
1111111111111
