1111111111111
100P000000001
100001000C001
1001E10000C01
1001110000001
1111111111111
