1111111111111
100P000000001
100110000C001
1001E00000C01
1001100000001
1111111111111
