1111111111111
100P000000001
100111000C001
1000E11100C01
1001000000001
1111111111111
