1111111111111
1000P00000001
1000000000001
1000000000001
100CE00000001
1111111111111
