1111111111111
100P000000001
100011000C001
1001E00100C01
1000100000001
1111111111111
