1111111
1000P01
1000001
1000001
100CE01
1111111
