1111111111111
1000P000C0001
10000000C0001
1000E00000001
100C000000001
1111111111111
