1111111111
1000P00001
1000000001
1000000001
100CE00001
1111111111
