11111111
1P0C1111
11000E11
11111111
