11111111
1EPCCCC1
11111111
11111111
