11111111
1PC00111
110P0011
11111111
