11111111
1P0C1011
11000E11
11111111
