11111111
1P0C0111
11000E11
11111111
