11111111
1P0C0011
11000E11
11111111
